XXXXXXXXXXXXXXXEXXXX
X  C      X        X
X         X        X
X         X        X
X                  X
X XXXXXXXXXXXXXXX  X
X  H H H H H H H   X
X                  X
X  H               X
X   H              X
X    H             X
X     H            E
X                  X
X                  X
X          X       X
X           X      X
X  A         X     X
X        H    X    X
X  A   A       X   X
XXXXXXXXXXXXXXXXXXXX