XXXXXXXXXXXXXXXXXXXX
X                  X
X   W        W     X
X                  X
X      WW          X
X                  X
X                  X
X                  X
X                  X
X         W        X
X                  X
X                  X
X                  X
X          W       X
X                  X
X  W               X
X           W      X
X                  X
X                  X
XXXXXXXXXXXXXXXXXXXX