XXXXXXXXXXXXXXXEXXXX
X               W  X
X                  X
X                  X
X                  X
X                  X
X                  X
X                  X
X                  X
X                  X
X          W       X
X                  E
X                  X
X                  X
X                  X
X     WW           X
X                  X
X                  X
X                  X
XXXXXXXXXXXXXXXXXXXX