XXXXXXXXXXXXXXXEXXXX
X                  X
X            W     X
X                  X
X                  X
X                  X
X                  X
X     W            X
X        W         X
X                  X
X                  X
X                  E
X                  X
X                  X
X                  X
X                  X
X                  X
X                  X
X                  X
XXXXXXXXXXXXXXXXXXXX