XXXXXXXXXXXXXXXEXXXX
X  C      X        X
X         X        X
X         X        X
X                  X
X XXXXXXXXXXXXXXX  X
X  H H             X
X                  X
X  H           H   X
X   H              X
X    H             X
X     H            E
X                  X
X                  X
X          X       X
X           X      X
X            X     X
X             X    X
X  A           X   X
XXXXXXXXXXXXXXXXXXXX