XXXXXXXXXXXXXXXXXXXXXXXXXXXXXXXXXXXXXXXX
X       X    X     X                   X
X       X    D     X                   X
X       D    XXXXXXX                   X
X       X    X     X                   X
XXXXXXXXX    D     X                   X
X            X     X                   X
X            X     D                   X
XXXXXXDXXXXXXX     X                   X
X            X     X                   X
X            XXXDXXXXXXXXXXXXDXXXXXXXXXX
X                  X     X       X     X
X                  X     X       X     X
X                  X     D       X     X
XXXXXXXXXXXXXXXDXXXX     X       X     X
X     X            X     X       D     X
X     X            X     X       X     X
X     D            X     X    A  X     X
X     X            X     X       X     X
XXXXXXXXXXXXXXXXXXXXXXXXXXXXXEXXXXXXXXXX