XXXXXXXXXXXXXXXXXXXXXXXXXXXXXXXXXXXXXXXX
XA      X    X     XAAAAAAAAAAAAAAAAAAAX
X       X    D    AXAAAAAAAAAAAAAAAAAAAX
X       D    XXXXXXXAAAAAAAAAAAAAAAAAAAX
X       X    X    AXAAAAAAAAAAAAAAAAAAAX
XXXXXXXXX    D     XAAAAAAAAAAAAAAAAAAAX
X            X     XAAAAAAAAAAAAAAAAAAAX
X            X     DAAAAAAAAAAAAAAAAAAAX
XXXXXXDXXXXXXX     XAAAAAAAAAAAAAAAAAAAX
X            X     XAAAAAAAAAAAAAAAAAAAX
X A          XXXDXXXXXXXXXXXXDXXXXXXXXXX
X     H            X     X   A   X     X
X                  X     X   A   X     X
X  C               X     D       X     X
XXXXXXXXXXXXXXXDXXXX     X   A   X     X
X     X            X     X       D     X
XA    X            X     X   A   X     X
X     D            X     X       X     X
X     X            X     X   A   X     X
XXXXXXXXXXXXXXXXXXXXXXXXXXXXXEXXXXXXXXXX