XXXXXXXXXXXXXXXXXXXXXXXXXXXXXXXXXXXXXXXX
XA      X    X     X                   X
X       X    D    AX                A  X
X       D    XXXXXXX      C            X
X       X    X    AX                   X
XXXXXXXXX    D     X                   X
X            X     X                   X
X            X     D                   X
XXXXXXDXXXXXXX     X         H         X
X            X     X                   X
X A          XXXDXXXXXXXXXXXXDXXXXXXXXXX
X     H            X     X       X     X
X                  X   H X       X     X
X  C               X     D       X     X
XXXXXXXXXXXXXXXDXXXX     X       X A   X
X     X            X  A  X       D     X
XA    X            X     X       X     X
X     D            X     X       X     X
X     X            X     X       X     X
XXXXXXXXXXXXXXXXXXXXXXXXXXXXXEXXXXXXXXXX