XXXXXXXXXXXXXXXXXXXXXXXXXXXXXXXXXXXXXXXX
XAAAAAAAXAAAAXAAAAAXAAAAAAAAAAAAAAAAAAAX
XAAAAAAAXAAAADAAAAAXAAAAAAAAAAAAAAAAAAAX
XAAAAAAADAAAAXXXXXXXAAAAAAAAAAAAAAAAAAAX
XAAAAAAAXAAAAXAAAAAXAAAAAAAAAAAAAAAAAAAX
XXXXXXXXXAAAADAAAAAXAAAAAAAAAAAAAAAAAAAX
XAAAAAAAAAAAAXAAAAAXAAAAAAAAAAAAAAAAAAAX
XAAAAAAAAAAAAXAAAAADAAAAAAAAAAAAAAAAAAAX
XXXXXXDXXXXXXXAAAAAXAAAAAAAAAAAAAAAAAAAX
XAAAAAAAAAAAAXAAAAAXAAAAAAAAAAAAAAAAAAAX
XAAAAAAAAAAAAXXXDXXXXXXXXXXXXDXXXXXXXXXX
XAAAAAAAAAAAAAAAAAAXAAAAAXAAAAAAAXAAAAAX
XAAAAAAAAAAAAAAAAAAXAAAAAXAAAAAAAXAAAAAX
XAAAAAAAAAAAAAAAAAAXAAAAADAAAAAAAXAAAAAX
XXXXXXXXXXXXXXXDXXXXAAAAAXAAAAAAAXAAAAAX
XAAAAAXAAAAAAAAAAAAXAAAAAXAAAAAAADAAAAAX
XAAAAAXAAAAAAAAAAAAXAAAAAXAAAAAAAXAAAAAX
XAAAAADAAAAAAAAAAAAXAAAAAXAAAAAAAXAAAAAX
XAAAAAXAAAAAAAAAAAAXAAAAAXAAAAAAAXAAAAAX
XXXXXXXXXXXXXXXXXXXXXXXXXXXXXEXXXXXXXXXX